recombined_construct,target,lane,adj_band_vol_int,band_vol_int,adj_lane_vol_int,lane_vol_int,bkgd_vol_int,norm_factor
G758A,ace2,1,9696060,19255500,12882672,44091432,31208760,N/A
G755A,ace2,2,32707092,51951372,34441176,69459456,35018280,N/A
G875A,ace2,3,33323268,53167620,35878458,73856442,37977984,N/A
G822A,ace2,4,32255454,49994406,37073982,71022666,33948684,N/A
G821A,ace2,5,34273470,46516206,40968972,64001916,23032944,N/A
G825F,ace2,6,34548822,46828914,42077970,64063296,21985326,N/A
G757A,ace2,7,24319746,33351186,33771936,51999024,18227088,N/A
G876C,ace2,8,33737286,46674606,41001180,64935222,23934042,N/A
G820E,ace2,9,12188352,20159040,24283710,50305662,26021952,N/A
G823B,ace2,10,34618320,47396184,41664678,66118866,24454188,N/A
G900A,ace2,11,22594308,35952180,28878630,56336478,27457848,N/A